{
  "blocks": [
    [6, 6, 6, 6, 6, 6, 6, 6, 6, 6, 6, 6, 6, 6, 6, 6, 6, 6, 6, 6, 6, 6, 6, 6],
    [
      6, 11, 5, 0, 0, 0, 5, 11, 5, 5, 11, 5, 0, 5, 0, 5, 11, 5, 11, 5, 0, 0, 2,
      6
    ],
    [
      6, 0, 0, 0, 5, 8, 5, 11, 0, 0, 0, 0, 5, 0, 5, 11, 11, 11, 11, 5, 5, 5, 5,
      6
    ],
    [6, 5, 0, 5, 5, 5, 5, 5, 0, 5, 5, 0, 0, 5, 14, 5, 5, 5, 5, 5, 17, 0, 0, 6],
    [
      6, 16, 0, 5, 11, 21, 0, 0, 0, 0, 0, 5, 0, 5, 15, 5, 0, 0, 0, 5, 0, 5, 5, 6
    ],
    [6, 5, 5, 5, 5, 5, 5, 5, 5, 5, 0, 5, 0, 5, 15, 5, 0, 5, 0, 18, 0, 0, 5, 6],
    [6, 0, 0, 0, 0, 0, 0, 0, 0, 5, 0, 5, 0, 5, 15, 5, 0, 5, 0, 0, 0, 5, 5, 6],
    [6, 0, 5, 5, 5, 5, 5, 5, 0, 5, 0, 5, 0, 5, 15, 5, 0, 5, 0, 0, 0, 0, 0, 6],
    [6, 0, 0, 0, 0, 0, 0, 5, 0, 0, 0, 0, 0, 0, 15, 0, 0, 5, 11, 5, 5, 5, 0, 6],
    [6, 5, 5, 5, 5, 5, 0, 5, 5, 5, 5, 5, 0, 5, 5, 5, 5, 5, 5, 5, 0, 0, 0, 6],
    [
      6, 8, 21, 0, 0, 0, 0, 11, 11, 11, 11, 5, 20, 5, 0, 0, 0, 0, 0, 0, 0, 5,
      11, 6
    ],
    [6, 6, 6, 6, 6, 6, 6, 6, 6, 6, 6, 6, 6, 6, 3, 6, 6, 6, 6, 6, 6, 6, 6, 6]
  ]
}
