{"blocks":[[6,6,6,6,6,6,6,6,6,6,6,6,6,6,6,6,6,6,6,3,6,6,6],
    [6,2,6,0,0,6,9,6,11,11,0,0,6,0,0,0,6,6,6,0,14,21,6],
    [6,6,6,6,0,6,11,6,6,6,6,0,0,0,6,0,0,0,0,0,15,0,6],
    [6,6,17,6,0,6,11,0,0,6,13,0,6,6,6,6,6,6,0,0,15,0,6],
    [6,6,0,0,0,6,0,6,0,6,0,0,0,0,0,0,0,6,0,0,15,0,6],
    [6,6,6,6,0,6,0,6,0,6,6,6,6,6,0,6,0,6,11,0,15,0,6],
    [6,11,11,6,0,0,0,6,0,6,0,0,0,6,0,6,0,6,6,6,6,0,6],
    [6,0,0,0,0,6,20,6,0,6,0,6,0,6,0,6,0,0,0,0,6,0,6],
    [6,0,4,4,0,6,6,6,0,6,0,6,0,16,0,6,6,6,6,11,6,0,6],
    [6,0,4,4,0,6,0,6,0,6,0,6,0,6,0,0,0,0,6,11,6,0,6],
    [6,21,0,0,0,0,0,6,0,0,11,6,0,6,0,6,0,11,11,11,6,12,6],
    [6,6,6,6,6,6,6,6,6,6,6,6,6,6,6,6,6,6,6,6,6,6,6]]}