{"blocks":[[1,1,1,1,1,1,1,1,1,1,1,1,1,1,1,1,1,1,1,1,1,1,1,1],
    [1,2,0,0,0,0,11,1,1,21,0,0,0,0,0,1,1,1,1,1,1,11,11,1],
    [1,1,1,1,1,0,0,1,1,1,1,1,0,0,0,1,1,1,1,1,1,0,11,1],
    [1,0,0,0,1,0,0,0,0,0,0,0,0,0,0,0,0,0,1,1,1,0,0,1],
    [1,0,1,20,1,0,0,1,1,1,1,1,1,0,0,1,1,0,1,1,1,0,0,1],
    [1,0,1,1,1,1,0,1,0,0,11,11,1,0,0,1,1,0,0,0,0,0,0,1],
    [1,0,0,0,0,0,11,1,0,0,0,0,1,0,0,1,1,1,0,1,1,0,0,1],
    [1,1,1,1,1,0,0,1,0,0,0,0,1,0,0,1,1,1,0,1,1,0,0,1],
    [1,0,0,21,1,0,0,1,0,0,0,0,1,0,0,1,1,1,0,1,1,0,0,1],
    [1,11,0,0,1,0,0,1,1,1,1,0,0,0,0,0,11,1,0,0,0,0,0,1],
    [1,0,0,0,0,0,0,1,1,1,1,1,1,11,0,1,1,1,1,1,0,0,11,1],
    [1,1,1,1,1,1,1,1,1,1,1,1,1,1,1,1,1,1,1,1,1,3,1,1]]}