{"blocks":[[4,4,4,4,4,4,4,4,4,4,4,4,4,4,4,4,4,4,4,4,7,7,7],
    [4,11,16,0,4,4,4,4,11,4,11,4,0,0,0,4,14,0,0,8,4,7,7],
    [4,0,4,0,0,0,0,4,11,4,0,4,0,0,0,4,15,0,0,0,0,4,7],
    [4,20,4,0,0,4,4,4,11,4,0,0,0,4,0,0,15,4,4,4,4,11,4],
    [4,0,0,0,0,0,11,4,0,4,4,0,0,4,0,0,15,4,12,0,11,11,4],
    [4,4,4,0,4,4,4,4,0,0,0,0,4,4,4,4,4,4,0,0,0,0,4],
    [4,0,0,0,4,0,11,4,0,4,0,0,4,2,4,0,0,4,4,4,0,0,4],
    [4,0,4,4,4,0,4,4,0,4,0,0,4,0,4,0,4,0,0,0,0,0,4],
    [4,0,0,0,4,0,4,0,0,4,0,4,4,0,0,0,4,0,0,4,4,0,4],
    [4,0,4,0,4,21,4,0,0,4,0,0,4,0,4,0,0,0,0,0,0,4,7],
    [4,11,4,0,0,0,11,0,0,4,4,12,4,8,4,0,0,0,0,0,4,7,7],
    [4,4,4,4,4,4,4,4,4,4,4,4,4,4,4,4,4,4,3,4,7,7,7]]}