{
  "blocks": [
    [4, 4, 4, 4, 4, 4, 4, 4, 4, 4, 4, 4, 4, 4, 4, 4, 4, 4, 4, 4, 4, 4, 4, 4],
    [
      4, 11, 4, 0, 0, 11, 4, 4, 13, 0, 0, 0, 0, 0, 0, 21, 22, 4, 11, 11, 4, 4,
      4, 4
    ],
    [4, 0, 0, 0, 4, 0, 0, 4, 4, 4, 4, 4, 4, 0, 4, 4, 0, 0, 4, 11, 11, 0, 0, 4],
    [4, 4, 4, 20, 0, 0, 0, 0, 0, 4, 4, 4, 4, 0, 4, 4, 4, 0, 4, 0, 4, 4, 4, 4],
    [4, 13, 4, 0, 4, 0, 4, 4, 0, 4, 4, 0, 0, 0, 0, 0, 0, 0, 4, 0, 0, 0, 4, 4],
    [4, 0, 4, 0, 4, 0, 4, 4, 0, 4, 0, 0, 4, 4, 4, 4, 4, 0, 4, 0, 4, 0, 0, 4],
    [4, 11, 0, 0, 0, 0, 0, 4, 0, 0, 0, 4, 0, 0, 0, 0, 4, 0, 4, 0, 4, 0, 4, 4],
    [4, 4, 0, 4, 0, 4, 4, 4, 4, 0, 4, 4, 4, 0, 4, 0, 4, 0, 4, 0, 4, 12, 11, 4],
    [4, 0, 0, 0, 0, 0, 0, 4, 4, 0, 4, 4, 4, 0, 4, 0, 4, 0, 4, 0, 4, 4, 4, 4],
    [4, 21, 4, 0, 0, 4, 0, 4, 0, 0, 0, 4, 0, 0, 4, 0, 4, 0, 4, 0, 0, 11, 11, 4],
    [4, 12, 4, 0, 0, 4, 2, 4, 0, 4, 0, 0, 0, 4, 4, 0, 4, 0, 0, 0, 4, 0, 0, 4],
    [4, 4, 4, 4, 4, 4, 4, 4, 4, 4, 4, 4, 4, 4, 4, 3, 4, 4, 4, 4, 4, 4, 4, 4]
  ]
}
