{"blocks":[
    [1,1,11,11,1,1,1,1,1,1,1,1,1,1,1,1,1,1,1,1,1,1,1],
    [1,11,1,1,16,20,1,1,11,1,11,11,11,0,0,1,11,11,0,0,12,12,1],
    [1,8,0,0,0,0,1,1,0,1,1,1,1,1,0,1,0,1,1,1,13,0,1],
    [1,1,1,1,1,0,11,1,0,1,0,0,0,0,0,1,0,0,11,1,1,1,1],
    [1,0,0,0,1,0,0,0,0,1,0,1,0,1,1,1,1,0,11,1,8,21,1],
    [1,0,1,2,1,0,1,1,0,1,0,1,0,1,14,0,0,0,1,1,0,0,1],
    [1,0,1,1,1,0,0,1,0,0,0,1,0,0,15,0,1,1,1,0,0,0,1],
    [1,0,0,0,0,0,0,1,0,0,1,1,0,0,15,0,1,11,0,0,0,0,1],
    [1,1,1,1,0,0,0,1,0,0,1,0,0,0,1,1,0,0,0,1,1,0,1],
    [1,21,0,0,0,1,0,1,0,0,1,0,1,0,0,0,0,1,1,1,0,0,1],
    [1,0,0,1,11,1,12,1,0,0,1,0,1,0,0,1,11,1,0,0,0,0,1],
    [1,1,1,1,1,1,1,1,1,1,1,1,1,1,1,1,1,1,3,1,1,1,1]]}