{
    "blocks": [
        [1,1,1,1,1,1,1,1,1,1,1,1,1,1,1,1,1,1,1,1,1,1,3,1],
        [1,11,11,1,0,11,0,1,11,1,0,0,0,0,14,0,5,0,0,0,0,0,0,1],
        [1,11,11,0,0,1,0,1,0,0,0,1,0,0,15,0,0,0,5,5,5,5,0,1],
        [1,11,11,1,0,1,0,1,1,1,1,1,0,0,15,0,5,5,5,11,11,5,0,1],
        [1,1,1,1,0,1,0,1,8,11,11,1,20,0,15,0,0,0,0,0,0,0,21,1],
        [1,21,0,0,0,0,0,1,11,11,11,0,0,0,15,0,5,5,5,5,5,5,5,1],
        [1,1,1,1,1,0,1,1,11,11,11,1,0,0,15,0,0,0,0,0,0,5,11,1],
        [1,0,0,0,1,0,0,1,1,0,1,1,1,1,1,1,1,1,0,1,0,0,0,1],
        [1,11,1,0,0,0,0,0,0,0,21,0,0,0,0,13,1,0,0,1,0,4,4,4],
        [1,1,1,0,1,1,0,1,1,1,1,1,0,1,1,1,1,0,1,1,0,4,8,4],
        [1,16,12,0,1,11,0,1,11,0,0,0,0,1,11,0,0,0,1,11,12,4,2,4],
        [1,1,1,1,1,1,1,1,1,1,1,1,1,1,1,1,1,1,1,1,1,4,4,4]]
}