{"blocks":[
    [5,5,5,5,5,5,5,5,5,5,5,5,5,5,5,5,5,5,5,5,5,5,5,5],
    [5,2,5,11,5,0,11,5,12,0,0,0,0,5,11,11,11,0,5,0,0,11,11,5],
    [5,0,5,0,5,11,0,5,5,5,5,5,0,5,5,5,5,0,5,21,0,0,0,5],
    [5,0,5,0,5,5,0,5,0,0,20,0,0,5,0,0,5,0,5,0,5,0,5,5],
    [5,0,0,0,0,0,0,5,0,6,0,5,5,5,0,0,14,0,5,0,5,0,0,5],
    [5,0,5,5,5,5,0,5,0,6,0,5,0,0,0,0,15,0,0,0,5,5,11,5],
    [5,0,0,5,12,5,0,5,0,0,0,5,0,0,5,5,15,0,5,5,5,0,0,5],
    [5,0,0,0,21,0,0,5,0,5,0,5,5,0,0,0,15,0,0,0,0,0,5,5],
    [5,0,5,0,5,5,0,5,0,5,0,0,0,0,5,5,5,5,0,5,0,0,0,5],
    [5,0,5,0,5,16,0,5,0,5,0,0,5,0,0,0,11,5,0,0,0,0,0,5],
    [5,11,5,11,5,0,0,0,0,5,0,13,5,0,0,11,12,5,0,0,0,0,0,5],
    [5,5,5,5,5,5,5,5,5,5,5,5,5,5,5,5,5,5,5,5,5,3,5,5]]}