{
    "blocks": [
        [1,1,1,1,1,1,1,1,0,0,0,0,0,0,0,0,0,0,0,0,0,0,0],
        [1,20,0,1,0,8,11,1,0,0,0,0,0,0,0,0,0,0,0,0,0,0,0],
        [1,0,1,1,11,11,11,1,0,0,0,0,0,0,0,0,0,0,0,0,0,0,0],
        [1,0,0,1,11,12,2,1,0,0,0,0,0,0,0,0,0,0,0,0,0,0,0],
        [1,1,0,1,1,1,1,1,0,0,0,0,0,0,0,0,0,0,0,0,0,0,0],
        [1,11,0,1,8,0,0,1,0,0,0,0,0,0,0,0,0,0,0,0,0,0,0],
        [1,0,1,1,1,1,0,1,0,0,0,0,0,0,0,0,0,0,0,0,0,0,0],
        [1,0,0,1,11,0,0,1,0,0,0,0,0,0,0,0,0,0,0,0,0,0,0],
        [1,1,0,1,1,0,0,1,0,0,0,0,0,0,0,0,0,0,0,0,0,0,0],
        [1,11,0,1,0,21,0,1,0,0,0,0,0,0,0,0,0,0,0,0,0,0,0],
        [1,0,0,0,0,0,0,1,0,0,0,0,0,0,0,0,0,0,0,0,0,0,0],
        [1,1,1,1,1,3,1,1,0,0,0,0,0,0,0,0,0,0,0,0,0,0,0]
    ]
}