{"blocks":[[1,1,1,1,1,1,1,1,1,1,1,1,1,1,1,1,1,1,1,1,1,1,1,1],
    [1,20,1,0,5,16,0,0,14,0,4,0,1,13,0,0,11,0,1,5,2,13,8,1],
    [1,0,1,0,5,0,0,0,15,0,0,0,1,0,0,1,0,0,0,5,0,0,0,1],
    [1,0,14,0,5,0,0,0,15,0,0,0,1,1,1,1,1,1,0,5,11,11,11,1],
    [1,8,15,0,5,9,9,0,15,0,0,0,14,0,0,0,0,0,0,5,5,5,5,1],
    [1,0,15,11,0,0,0,0,15,0,0,0,15,0,0,0,0,0,0,14,0,0,11,1],
    [1,0,5,11,0,0,0,6,15,0,0,0,15,0,4,12,0,1,1,15,1,1,1,1],
    [1,0,5,11,0,0,0,6,15,0,0,0,15,0,4,0,0,0,0,15,0,0,0,1],
    [1,0,5,11,0,0,0,6,15,0,0,4,15,21,4,4,4,0,0,15,0,0,0,1],
    [1,0,5,11,0,0,0,6,15,0,0,4,15,0,4,11,4,0,0,15,0,11,11,1],
    [1,21,5,0,8,0,0,6,15,0,0,4,15,0,0,0,4,0,0,15,0,0,11,1],
    [1,1,1,1,1,1,1,1,1,1,1,1,1,1,1,1,1,1,1,1,3,1,1,1]]}